1111111111111
1000000000001
100011111ECP1
1000000011111
1111111111111