11111111111111111
10000000000000001
1E0C00000000000P1
10000000000000001
11111111111111111