11111111111111111
10000000000000001
100C0000E000000P1
10000000000000001
11111111111111111