11111111111111111
10000000000000001
1000000000000ECP1
10000000000000001
11111111111111111