1111111111111
1E00000C00001
10000000000P1
1111111111111