1111111111111
1000000x00001
1111111111111
