1111111111111
1E00000C00011
1000000000001
1111111111111
